BBBBBBBBBBBBBBBBBBBBBBBBBBBBBBBB
B------------------------------B
B------------------------------B
B------------------------------B
B------------------------------B
B------------------------------B
B------------------------------B
B------------------------------B
B------------------------------B
B------------------------------B
B------------------------------B
B------------------------------B
B------------------------------B
B------------------------------B
B------------------------------B
B------------------------------B
B------------------------------B
BWWWWWWWWWWWWWWWWWWWWWWWWWWWWWWB
B------------------------------B
B------------------------------B
B-------------BBBBB------------B
B------------------------------B
B------------------------------B
B------------------------------B
BBBBBBBBBBBBB-------BBBBBBBBBBBB
B------------------------------B
B-------------W----------------B
B----------WWWW----------------B
B------------------------------B
B------------------------------B
BBBBB--------------------------B
B------------------------------B
B------------------------------B
B-----WWWWWW----------WWWWW----B
B------------------------------B
B------------------------------B
B------------------------------B
B----------------------------BBB
B------------------------------B
B------------------------------B
B------------------------------B
B----B------------WW------W----B
B----B-----------------------BBB
B----B------W------------------B
B----B-------------------------B
B--BBB-------------------------B
B------------------------------B
B------------------------------B
B------------------------------B
B------------------------------B
BBBBBBBBBBBBBBBBB----BBBBBBBBBBB
B------------------------------B
B------------------------------B
B---WWW---WWW---------WWWWW----B
B----------------WWW-----------B
B------------------------------B
BBB----------------------------B
B------------------------------B
B--------------------------BBBBB
B------------------------------B
B---WWWWWWWW-------------------B
B------------------------------B
B------------------------------B
B---WWWWWWWW-------------------B
B------------------------------B
B------------------------------B
B----------------WWWWWWW-------B
B---------------WWWWWWWWW------B
B----B---------WWWWWWWWWWW-----B
BWWWWB---------WWWWWWWWWWWW----B
BWWWWB-------WWWWWWWWWWWWWW----B
BWWWWB--------WWWWWWWWWWWW-----B
BBBBBB---------WWWWWWWWWW------B
B--------------WWWWWWWWWW------B
B------------------------------B
B---------W--------------------B
B----------------------------WWW
B---WWWWW----------------------B
B------------------------------B
B-----B------------------------B
B-----B------------------------B
B-----B------------------------B
B--WWWW--------------BBBBBBBBBBB
B--------------------BBBBBBBBBBB
B--------BB----------BBBBBBBBBBB
B-------BBB----------BBBBBBBBBBB
B--BBBBBBBB----------BBBBBBBBBBB
B--BBBBBBBB----------BBBBBBBBBBB
BBBBBBBBBBB----------BBBBBBBBBBB
DDDDDDDDDDDDDDDDDDDDDDDDDDDDDDDD
